6 6
WWWWWW
WNNNNW
WNNBNW
WNNPNW
WNNNNW
WWWWWW
