8 7
WWWWWWW
WNNNNNW
WNNBNNW
WNNPGNW
WNNNNNW
WNNNNNW
WWWWWWW
NNNNNNN
