8 10
NNNWWWNNNN
NNNWGWNNNN
NNNWNWWWWN
NWWWBNBGWN
NWGNBPWWWN
NWWWWBWNNN
NNNNWGWNNN
NNNNWWWNNN
