10 9
WWWWWNNNN
WPNNWNNNN
WNBBWNWWW
WNBNWNWGW
WWWNWWWGW
NWWNNNNGW
NWNNNWNNW
NWNNNWWWW
NWWWWWNNN
NNNNNNNNN
