7 10
NNNWWWWWWN
NWWWNNNNWN
WWGNBWWNWW
WGGBNBNNPW
WGGNBNBNWW
WWWWWWNNWN
NNNNNWWWWN
